⠿⠿⠿⠿⠿⠿⠿⠿⠿⠿⠿⠿⠿⠿⠿⠿⠿⠿⠿⠿⠿⠿⠿⠿⠿⠿⠿⠿⠿⠿⠿⠿⠿⠿⠿⠿⠿⠿⠿⠿⠿⠿⠿⠿⠿⠿⠿⠿⠿⠿⠿⠿⠿⠿⠿⠿⠿⠿⠿⠿⠿⠿⠿⠿⠿⠿⠿⠿⠿⠿
⠿⠿⠿⠿⠿⠿⠿⠿⠿⠿⠿⠿⠿⠿⠿⠿⠿⠿⠿⠿⠿⠿⠿⠿⠿⠿⠿⠿⠿⠿⠿⠿⠿⠿⠿⠿⠿⠿⠿⠿⠿⠿⠿⠿⠿⠿⠿⠿⠿⠿⠿⠿⠿⠿⠿⠿⠿⠿⠿⠿⠿⠿⠿⠿⠿⠿⠿⠿⠿⠿
⠿⠿⠿⠿⠿⠿⠟⠿⠿⠿⠿⠿⠿⠿⠿⠿⠿⠿⠿⠿⠿⠿⠿⠿⠿⠿⠿⠿⠿⠿⠿⠿⠿⠿⠿⠿⠿⠿⠿⠿⠿⠿⠿⠿⠿⠿⠿⠿⠿⠿⠿⠿⠿⠿⠿⠿⠿⠿⠿⠿⠿⠿⠿⠟⠿⠿⠿⠿⠿⠿
⠿⠿⠿⠿⠿⠏⠏⠿⠿⠿⠿⠿⠿⠿⠿⠿⠿⠿⠿⠿⠿⠿⠿⠿⠿⠿⠿⠿⠿⠿⠿⠿⠿⠿⠿⠿⠿⠿⠿⠿⠿⠿⠿⠿⠿⠿⠿⠿⠿⠿⠿⠿⠿⠿⠿⠿⠿⠿⠿⠿⠿⠿⠿⠏⠟⠿⠿⠿⠿⠿
⠿⠿⠿⠿⠿⠏⠿⠏⠿⠿⠿⠿⠿⠿⠿⠿⠿⠿⠿⠿⠿⠿⠿⠿⠿⠿⠿⠿⠿⠟⠟⠏⠏⠏⠏⠏⠏⠏⠏⠟⠟⠿⠿⠿⠿⠿⠿⠿⠿⠿⠿⠿⠿⠿⠿⠿⠿⠿⠿⠿⠿⠿⠏⠿⠏⠿⠿⠿⠿⠿
⠿⠿⠿⠏⠟⠏⠿⠿⠏⠿⠿⠿⠿⠿⠿⠿⠿⠿⠿⠿⠿⠿⠟⠏⠏⠏⠏⠟⠿⠿⠿⠿⠿⠟⠿⠿⠟⠿⠿⠿⠿⠿⠟⠏⠏⠏⠏⠟⠿⠿⠿⠿⠿⠿⠿⠿⠿⠿⠿⠿⠿⠏⠿⠿⠏⠿⠏⠿⠿⠿
⠿⠿⠿⠏⠏⠏⠿⠿⠿⠏⠏⠿⠿⠿⠿⠿⠿⠟⠏⠏⠏⠿⠿⠿⠿⠿⠟⠟⠟⠏⠏⠏⠏⠏⠏⠏⠏⠏⠏⠏⠏⠟⠿⠟⠿⠟⠿⠿⠿⠏⠏⠏⠟⠿⠿⠿⠿⠿⠿⠏⠏⠿⠿⠿⠏⠏⠏⠿⠿⠿
⠿⠿⠟⠏⠿⠿⠏⠟⠿⠿⠟⠏⠏⠟⠏⠏⠏⠿⠿⠿⠿⠟⠏⠏⠟⠏⠏⠏⠏⠏⠏⠏⠏⠏⠏⠏⠏⠏⠏⠏⠏⠏⠏⠏⠟⠏⠏⠏⠟⠿⠟⠿⠿⠏⠏⠏⠟⠏⠏⠟⠿⠿⠟⠏⠿⠿⠏⠿⠿⠿
⠿⠿⠿⠏⠿⠿⠿⠿⠏⠿⠏⠿⠿⠿⠏⠟⠿⠟⠏⠏⠏⠏⠏⠏⠏⠏⠟⠏⠏⠏⠏⠿⠿⠿⠿⠿⠿⠿⠿⠏⠏⠏⠏⠿⠏⠏⠏⠏⠏⠏⠏⠏⠟⠟⠏⠏⠿⠿⠟⠏⠿⠏⠿⠿⠿⠟⠏⠿⠿⠿
⠿⠿⠏⠏⠏⠏⠟⠿⠟⠿⠟⠟⠏⠿⠿⠿⠟⠏⠏⠏⠏⠏⠏⠏⠟⠏⠿⠿⠏⠟⠿⠿⠟⠿⠿⠿⠿⠟⠿⠟⠟⠟⠿⠿⠏⠟⠏⠏⠏⠏⠏⠏⠏⠟⠿⠿⠿⠏⠟⠟⠿⠟⠿⠟⠏⠟⠏⠏⠿⠿
⠿⠿⠟⠏⠿⠏⠏⠏⠟⠟⠟⠟⠟⠏⠟⠟⠿⠿⠿⠟⠏⠏⠏⠏⠏⠏⠏⠟⠿⠿⠿⠟⠟⠟⠿⠿⠟⠟⠟⠿⠿⠿⠟⠏⠏⠏⠏⠏⠏⠏⠟⠿⠿⠿⠟⠟⠏⠟⠟⠟⠟⠟⠏⠏⠏⠿⠏⠿⠿⠿
⠿⠿⠿⠟⠏⠿⠿⠿⠏⠏⠟⠟⠟⠏⠟⠏⠏⠟⠟⠟⠿⠿⠟⠏⠏⠿⠿⠏⠏⠟⠿⠿⠿⠿⠟⠟⠿⠿⠿⠿⠟⠏⠏⠿⠿⠏⠏⠿⠿⠿⠟⠟⠟⠏⠏⠟⠏⠟⠟⠟⠏⠏⠿⠿⠿⠏⠟⠿⠿⠿
⠿⠿⠿⠏⠟⠏⠿⠿⠟⠿⠿⠟⠏⠏⠟⠏⠏⠏⠏⠏⠟⠟⠟⠿⠏⠿⠟⠿⠏⠿⠏⠏⠟⠿⠏⠏⠿⠟⠏⠏⠿⠏⠿⠏⠿⠏⠿⠟⠟⠟⠏⠏⠏⠏⠏⠟⠏⠏⠟⠿⠿⠟⠿⠿⠏⠟⠏⠿⠿⠿
⠿⠿⠿⠿⠏⠟⠿⠏⠏⠿⠟⠟⠟⠟⠟⠟⠏⠏⠏⠏⠏⠏⠏⠏⠏⠿⠏⠿⠟⠏⠟⠏⠏⠏⠏⠏⠏⠏⠟⠟⠏⠟⠿⠏⠿⠏⠏⠏⠏⠏⠏⠏⠏⠏⠟⠏⠟⠟⠟⠟⠟⠏⠟⠿⠏⠏⠿⠿⠿⠿
⠿⠿⠿⠿⠿⠟⠏⠿⠿⠟⠟⠿⠏⠏⠏⠏⠏⠏⠏⠏⠏⠏⠏⠏⠏⠟⠿⠏⠿⠿⠿⠿⠟⠏⠟⠟⠏⠟⠿⠿⠿⠟⠏⠿⠟⠏⠏⠏⠏⠏⠏⠏⠏⠏⠏⠏⠏⠏⠿⠟⠟⠿⠟⠏⠟⠿⠿⠿⠿⠿
⠿⠿⠿⠿⠿⠿⠏⠟⠟⠏⠏⠏⠏⠏⠏⠏⠏⠏⠏⠏⠏⠏⠏⠏⠟⠏⠏⠏⠟⠟⠟⠟⠏⠟⠟⠏⠟⠏⠟⠟⠟⠟⠏⠟⠏⠏⠏⠏⠏⠏⠏⠏⠏⠏⠏⠏⠏⠏⠏⠏⠏⠟⠏⠏⠿⠿⠿⠿⠿⠿
⠿⠿⠿⠿⠿⠿⠿⠿⠏⠏⠏⠿⠿⠟⠏⠏⠏⠏⠏⠟⠏⠏⠏⠏⠟⠟⠏⠏⠟⠏⠏⠟⠟⠟⠟⠟⠟⠟⠟⠏⠏⠟⠏⠏⠟⠟⠏⠏⠏⠏⠟⠏⠏⠏⠏⠏⠿⠿⠿⠏⠏⠏⠿⠿⠿⠿⠿⠿⠿⠿
⠿⠿⠿⠿⠿⠿⠿⠿⠿⠟⠏⠏⠿⠿⠿⠟⠏⠟⠏⠏⠏⠟⠏⠏⠏⠟⠟⠟⠟⠿⠿⠟⠟⠟⠟⠟⠟⠟⠟⠿⠟⠟⠟⠟⠟⠏⠏⠏⠟⠏⠏⠏⠟⠏⠟⠿⠿⠿⠏⠏⠟⠿⠿⠿⠿⠿⠿⠿⠿⠿
⠿⠿⠿⠿⠿⠿⠿⠿⠿⠿⠿⠿⠏⠏⠏⠏⠏⠏⠿⠿⠏⠿⠏⠏⠏⠟⠟⠿⠿⠿⠿⠿⠿⠿⠟⠟⠿⠿⠿⠿⠿⠿⠿⠟⠟⠏⠟⠏⠿⠏⠿⠟⠏⠏⠏⠏⠏⠟⠿⠿⠿⠿⠿⠿⠿⠿⠿⠿⠿⠿
⠿⠿⠿⠿⠿⠿⠿⠿⠿⠿⠿⠿⠿⠿⠿⠿⠏⠏⠿⠿⠏⠿⠟⠏⠏⠟⠏⠟⠿⠿⠿⠿⠟⠿⠿⠿⠿⠟⠿⠿⠿⠿⠟⠏⠟⠏⠏⠟⠟⠏⠿⠿⠏⠏⠿⠿⠿⠿⠿⠿⠿⠿⠿⠿⠿⠿⠿⠿⠿⠿
⠿⠿⠿⠿⠿⠿⠿⠿⠿⠿⠿⠿⠿⠿⠿⠿⠿⠏⠏⠿⠿⠏⠏⠏⠏⠏⠏⠏⠟⠟⠟⠟⠿⠟⠟⠟⠟⠟⠟⠟⠟⠏⠏⠏⠏⠏⠏⠏⠏⠿⠿⠏⠏⠿⠿⠿⠿⠿⠿⠿⠿⠿⠿⠿⠿⠿⠿⠿⠿⠿
⠿⠿⠿⠿⠿⠿⠿⠿⠿⠿⠿⠿⠿⠿⠿⠿⠿⠿⠟⠏⠿⠿⠏⠟⠏⠏⠟⠏⠿⠏⠟⠏⠟⠟⠟⠟⠟⠟⠏⠟⠏⠿⠏⠏⠏⠟⠟⠏⠿⠿⠏⠟⠿⠿⠿⠿⠿⠿⠿⠿⠿⠿⠿⠿⠿⠿⠿⠿⠿⠿
⠿⠿⠿⠿⠿⠿⠿⠿⠿⠿⠿⠿⠿⠿⠿⠿⠿⠿⠿⠟⠟⠟⠿⠏⠟⠏⠏⠏⠿⠟⠟⠏⠏⠏⠟⠏⠏⠏⠏⠟⠟⠿⠟⠏⠏⠟⠏⠟⠟⠟⠟⠿⠿⠿⠿⠿⠿⠿⠿⠿⠿⠿⠿⠿⠿⠿⠿⠿⠿⠿
⠿⠿⠿⠿⠿⠿⠿⠿⠿⠿⠿⠿⠿⠿⠿⠿⠿⠿⠟⠟⠿⠏⠏⠏⠏⠏⠟⠏⠏⠏⠟⠏⠏⠏⠏⠏⠏⠏⠏⠏⠏⠏⠏⠟⠟⠏⠏⠟⠏⠿⠏⠿⠿⠿⠿⠿⠿⠿⠿⠿⠿⠿⠿⠿⠿⠿⠿⠿⠿⠿
⠿⠿⠿⠿⠿⠿⠿⠿⠿⠿⠿⠿⠿⠿⠿⠿⠿⠿⠟⠿⠏⠟⠟⠟⠏⠏⠏⠟⠟⠏⠏⠏⠏⠏⠏⠏⠟⠏⠟⠏⠏⠟⠟⠏⠏⠏⠟⠟⠟⠏⠿⠿⠿⠿⠿⠿⠿⠿⠿⠿⠿⠿⠿⠿⠿⠿⠿⠿⠿⠿
⠿⠿⠿⠿⠿⠿⠿⠿⠿⠿⠿⠿⠿⠿⠿⠿⠿⠿⠿⠿⠟⠿⠿⠿⠿⠏⠏⠿⠿⠟⠏⠟⠟⠟⠏⠏⠟⠟⠿⠏⠟⠿⠿⠏⠏⠿⠿⠿⠿⠟⠿⠿⠿⠿⠿⠿⠿⠿⠿⠿⠿⠿⠿⠿⠿⠿⠿⠿⠿⠿
⠿⠿⠿⠿⠿⠿⠿⠿⠿⠿⠿⠿⠿⠿⠿⠿⠿⠿⠿⠿⠿⠿⠿⠿⠿⠿⠿⠏⠏⠟⠿⠿⠏⠏⠟⠿⠏⠏⠿⠿⠟⠏⠏⠿⠿⠿⠿⠿⠿⠿⠿⠿⠿⠿⠿⠿⠿⠿⠿⠿⠿⠿⠿⠿⠿⠿⠿⠿⠿⠿
⠿⠿⠿⠿⠿⠿⠿⠿⠿⠿⠿⠿⠿⠿⠿⠿⠿⠿⠿⠿⠿⠿⠿⠿⠿⠿⠿⠿⠿⠟⠏⠏⠿⠿⠿⠿⠿⠿⠏⠏⠟⠿⠿⠿⠿⠿⠿⠿⠿⠿⠿⠿⠿⠿⠿⠿⠿⠿⠿⠿⠿⠿⠿⠿⠿⠿⠿⠿⠿⠿
⠿⠿⠿⠿⠿⠿⠿⠿⠿⠿⠿⠿⠿⠿⠿⠿⠿⠿⠿⠿⠿⠿⠿⠿⠿⠿⠿⠿⠿⠿⠿⠿⠏⠏⠏⠏⠏⠏⠿⠿⠿⠿⠿⠿⠿⠿⠿⠿⠿⠿⠿⠿⠿⠿⠿⠿⠿⠿⠿⠿⠿⠿⠿⠿⠿⠿⠿⠿⠿⠿
⠿⠿⠿⠿⠿⠿⠿⠿⠿⠿⠿⠿⠿⠿⠿⠿⠿⠿⠿⠿⠿⠿⠿⠿⠿⠿⠿⠿⠿⠿⠿⠿⠿⠿⠿⠿⠿⠿⠿⠿⠿⠿⠿⠿⠿⠿⠿⠿⠿⠿⠿⠿⠿⠿⠿⠿⠿⠿⠿⠿⠿⠿⠿⠿⠿⠿⠿⠿⠿⠿
⠿⠿⠿⠿⠿⠿⠿⠿⠿⠿⠿⠿⠿⠿⠿⠿⠿⠿⠿⠿⠿⠿⠿⠿⠿⠿⠿⠿⠿⠿⠿⠿⠿⠿⠿⠿⠿⠿⠿⠿⠿⠿⠿⠿⠿⠿⠿⠿⠿⠿⠿⠿⠿⠿⠿⠿⠿⠿⠿⠿⠿⠿⠿⠿⠿⠿⠿⠿⠿⠿